StatusRequest	KEYWORD1
Scheduler	KEYWORD1
Task	KEYWORD1
signal	KEYWORD2
isFirstIteration	KEYWORD2
isLastIteration	KEYWORD2
signalComplete	KEYWORD2
waitFor	KEYWORD2
waitForDelayed	KEYWORD2
reset	KEYWORD2
set	KEYWORD2
setIterations	KEYWORD2
enable	KEYWORD2
enableIfNot	KEYWORD2
enableDelayed	KEYWORD2
delay	KEYWORD2
forceNextIteration	KEYWORD2
setInterval	KEYWORD2
disable	KEYWORD2
restart	KEYWORD2
restartDelayed	KEYWORD2
init	KEYWORD2
addTask	KEYWORD2
deleteTask	KEYWORD2
disableAll	KEYWORD2
enableAll	KEYWORD2
setHighPriorityScheduler	KEYWORD2
allowSleep	KEYWORD2
startNow	KEYWORD2
execute	KEYWORD2