M_2PI	LITERAL1
M_PI2	LITERAL1
ERROR	LITERAL1
filterSamples	LITERAL1
PLANNING_FREQ	LITERAL1
GOING_TO_WAYPOINT	LITERAL1
GOING_TO_BOTTLE	LITERAL1
GOING_HOME	LITERAL1
DEPOSITION	LITERAL1
HOME_X	LITERAL1
HOME_Y	LITERAL1
EMPTY	LITERAL1
BOTTLE	LITERAL1
TARGET	LITERAL1
NB_WAYPOINTS	LITERAL1
NB_BOTTLES_ARRAY	LITERAL1
MS_OFFSET	LITERAL1
Kmotors_plus	LITERAL1
Kmotors_minus	LITERAL1
DIST_GOAL_THRESH	LITERAL1
BEARING_GOAL_TRESH	LITERAL1
SPEED_UNIT_RADS	LITERAL1
INIT_X	LITERAL1
INIT_Y	LITERAL1
INIT_THETA	LITERAL1
COMPASS_WEIGHT	LITERAL1
WHEEL_BASE	LITERAL1
WHEEL_RADIUS	LITERAL1
TICKS_PER_REV	LITERAL1
TICKS_PER_M	LITERAL1
PUSHER_TIME	LITERAL1
PUSHER_INIT_POS	LITERAL1
PUSHER_SPEED	LITERAL1
PUSHER_HALF_PERIOD	LITERAL1
PUSHER_RESET_PERIOD	LITERAL1
DEPOSITION_DELAY	LITERAL1
DOOR_INIT_POS	LITERAL1
DOOR_END_POS	LITERAL1
DOOR_CLOSE_POS	LITERAL1
DOOR_DEPOSITION_POS	LITERAL1
DOOR_SPEED	LITERAL1
DOOR_HALF_PERIOD	LITERAL1
DOOR_OPEN	LITERAL1
DOOR_CLOSE	LITERAL1
DOOR_MOVE	LITERAL1
DOOR_DEPOSITION 	LITERAL1
N_SENSORS	
OBS_THRESH
CRIT_OBS_THRESH
WALL_THRESH
KplusIR
KminusIR

#define WALL_CAL_THRESH	40
#define SENSOR_SEPERATION	21		//In centimeters, the distance between the right and left sensors
#define ROBOT_LEFT	0
#define ROBOT_RIGHT	1
#define ROBOT_BACk	2
#define	WALL_BOTTOM	0
#define	WALL_RIGHT 	1
#define	WALL_LEFT 	2
#define	WALL_TOP 	3
#define HALF_ROBOT_WIDTH 150

#define FULL_DELAY	60000
#define FULL_THRESHOLD	5			//number of times it is full to be considered full
#define FULL_N		5

#define EVASIVE_MANOEUVRE_DELAY	1000/PLANNING_FREQ
#define ITS_TOO_LATE_INT	570000
#define ITS_BEEN_TOO_LONG_INT