robotState	KEYWORD1
destination	KEYWORD1
left_speed	KEYWORD1
right_speed	KEYWORD1
planning	KEYWORD2
deposition	KEYWORD2
DymxDoor_setState	KEYWORD2
get_info_from_pi	KEYWORD2
tCaptureBottle	KEYWORD2
goHomeItsTooLate	KEYWORD2
goHomeItsBeenTooLong	KEYWORD2
tprint	KEYWORD2
PlanningTask	KEYWORD2
OdometryTask	KEYWORD2
CaptureBottleTask	KEYWORD2
DoorMoveTask	KEYWORD2
FullTask	KEYWORD2
PusherTask	KEYWORD2
PusherResetTask	KEYWORD2
goHomeItsTooLateTask	KEYWORD2
goHomeItsBeenTooLongTask	KEYWORD2
PrintTask	KEYWORD2
runner	KEYWORD1